11111111111111111111111111111111
10010000000000000000000000000011
10010000010000001000100000000101
10010000001000001010001000001001
10010000000100001000000100010001
10010000000010000000000000100001
10000000000001000000000001000001
1000000C000000100000000010000001
10000000000000010000000100000001
1001000E0P0000000000000000000001
10010000000000000100010000000001
1001000C000000000010100000000001
10010000000000000001000000000001
10000000000000000000100000000001
10000000000000000010001000000001
10010000000000001000000100000001
10010000000000100000000010000001
11111111111111111111111111111111
